25;marron;
#########################
#########################
#########################
###....#....-....#....###
###*##.#.#######.#.##*###
###...................###
####.#.####.#.####.#.####
####.#.####.#.####.#.####
.....#......#......#.....
####.###.#######.###.####
####........@........####
####.###.###F###.###.####
####.#...##FFF##...#.####
####.#.#.#######.#.#.####
.......#.........#.......
####.######.#.######.####
####........#........####
####.#.##.#####.#.##.####
###.........P.........###
###.###.###.#.###.###.###
###.###.#...#...#.###.###
###*###.#.#####.#.###*###
###.........-.........###
#########################
#########################
