25;green;
#########################
#########################
#########################
.........................
####.#.#####.#####.#.####
####.#......P......#.####
####.#.#####.#####.#.####
###..#.....#.#.....#..###
###.######.#.#.######.###
###...*#.........#*...###
###.##...#.#.#.#...##.###
###.####.#.#.#.#.####.###
###......#.#.#.#......###
####.#####.....#####.####
####...###.#.#.###...####
###..#.....#.#.....#..###
###.######.#.#.######.###
###-...#...#.#...#...-###
####.#...###.###...#.####
####.###.###.###.###.####
####.*.#.........#.*.####
####.#.#.###F###.#.#.####
.........##FFF##.........
#########################
#########################
